{
	"m1" : [
	"xxxxxxxxxxxx",
	"x..x........",
	"x....xx.....",
	"x........x..",
	"x.x.....xx..",
	"x.xx........",
	"x...........",
	"x.....xx....",
	"xx.....x....",
	"x...........",
	"x..........x"],

	"m2" : [
	"xxxxxxxxxxxx",
	"x....x......",
	"x.x.....xx..",
	"x.xx.....x..",
	"x...........",
	"x...x.......",
	"x..xx.......",
	"x........xx.",
	"xx.......x..",
	"x...........",
	"x...........",
	"x..........x"],

	"m3" : [
	"xxxxxxxxxxxx",
	"x......x....",
	"x....x......",
	"x...xx......",
	"x...........",
	"x...x...x...",
	"x..xx...xx..",
	"xx..........",
	"x......xx...",
	"x.......x...",
	"x...........",
	"x..........x"],

	"m4" : [
	"xxxxxxxxxxxx",
	"x.x.........",
	"x...........",
	"x...x.......",
	"x..xx.......",
	"xx......x...",
	"x.......xx..",
	"x...........",
	"x..x........",
	"x..xx....x..",
	"x.......xx..",
	"x..........x"]
}